 
C  255, 255, 250
F  39 , 35 , 36  
NO ./pics/losanges.xpm	
SO ./pics/uni_orange.xpm	
WE ./pics/dj.xpm		 	         
EA ./pics/yolandi.xpm 
S ./pics/oeil13.xpm	     

R 800 900

	1111111111111111111111111111111111111111
	100002000002000010001002000000001111111111
	10000000020000020001000000001111111111
	1000000000000000111110000000001111111111
	10000200012000000200000011111111111	
	100000001000N0100000101111111111	
	100000000000100100000000000001111111111
	10002000000010000000000000001111111111
	100000002111111100000020000001111111111
	10000000000000111111111111111111111	
	11111111111111111111111111111111	

