 
C   255, 25, 255
      NO    ./pics/barrel.xpm
 SO ./pics/greenlight.xpm
    WE      ./pics/purplestone.xpm    
  EA ./pics/redbrick.xpm


      S ./pics/barrel.xpm
F  0   ,255,   0

R 600 800

1111111111111111111111111111111
1  10000000000002000000000000011111111
   10000000000200000020000000000200000111
   10000000020000002000W000000000000011111111         
   1000000000000200000000002000000000001           
   1000000000020000000000020000000000001    
   1000000000000000000000002000002000001
   1000000000000000020000000200000000001
   111111111111111111111111111111111111
