 
C   255, 0, 255
      NO    ./pics/barrel.xpm
 SO ./pics/greenlight.xpm
    WE ./pics/purplestone.xpm
  EA ./pics/redbrick.xpm


      S ./pics/barrel.xpm
F  0   ,255,   0 

R 1000 1000  


      11111111     1111111 11111111111
   11111111111111111 111111111111
        111011000111 110111111111         
        1000000000111000000000001          
        101100200000W000200000001          
        1001000000000000000000111
   111111111011000111111100000001
   1000000000110001      1001110111111111111
   1111111111111101      1100000010001   
         1111011111     1111011101111111111
         110000001111111111000000100001
           1111111111111111111111111111

  1111111111111111111111111111
   11111111110000000000000001111111111
   1000200000000001100000011111
   1000000000000000110101001
   110000011101010111110111111
   111101110 1111101 11101101
   111111111111111111111111111
