 
C   255, 25, 255
      NO    ./pics/barrel.xpm
 SO ./pics/greenlight.xpm
    WE      ./pics/purplestone.xpm    
  EA ./pics/redbrick.xpm


      S ./pics/barrel.xpm
F  0   ,255,   0

R 300 300

1111111111111111111111111111111
1  1000000000000000000000000011111111
   10000000000000000000000000000000001111
   100000020000000000W000000000000200011111111         
   10000000000000000000000000000000001           
   10000000000000000000000000000000001    
   10000000000000000000000000000000001
   10000000000000000000000000000000001
   11111111111111111111111111111111111
