 
C   255, 25, 255
      NO    ./pics/barrel.xpm
 SO ./pics/greenlight.xpm
    WE      ./pics/purplestone.xpm    
  EA ./pics/redbrick.xpm


      S ./pics/barrel.xpm
F  0   ,255,   0

R 600 800


1111111111111111
1000000000000001
1000000000222201
1000000000000001
10000000000000N1
1111111111111111
