 
	C   255     , 25 , 255	
      NO    ./pics/pillar.xpm	
	 SO ./pics/barrel.xpm	
    WE      ./pics/purplestone.xpm		 	         
  EA ./pics/mossy.xpm	      


      S ./pics/barrel.xpm	     
	F  0   ,255,   0  

		R 600 800	

	11111111111111111111111111111111	  
	1111111111111111000000000000001	
	100000002222222100000000000001111111111	
	100000000000000100000	0000000001
	1111111111111111111111111111111111111111111111111111111111111	

	11111111111111111111111111111111	11111111111111111111111111111111	
	1000000000000001000	00000000001111111111
	1000000000000000000S000000001111111111	
	10000000000000010000000000	0001111111111
	1000000022222	221000	0000000000011111111111	
	100000002222222100000000000001111111111	
	100000000000000100000000000001111111111
	100000000000000000000	0000001111111111
	100000000000000100000000000001111111111
	10000000000000111111111111111111111	
	11111111111111111111111111111111	

