R 1920 1080
NO ./path_to_the_north_texture
SO ./path_to_the_south_texture
WE ./path_to_the_west_texture
EA ./path_to_the_east_texture

S ./path_to_the_sprite_texture
F 220,100,0
C 225,30,0

   11111111     1111111 111111111111
   111111111111X11111 111111111111
        111111000111 111111111111         
        1000000000110000000000001          
        1011000000000000000000001          
        1001000000000000000000001
   1111111110110000011101000000001
   100000000011000001110111111111111
   11111111111111011100000010001   
         11110111111111011101111111111
         11000000110101011100000010001
   11111111110000000000000000001111111111
   10002000000000001100000011111
   1000000000000000110101001
   1100000111010101111101111111
   11110111 1111101 11111101001
   11111111 1111111 11111111111