 
	C   0, 0, 0
      NO    ./pics/panthOBF.xpm	
	 SO ./pics/oeil14.xpm	
    WE      ./pics/uni_orange.xpm		 	         
  EA ./pics/gribou1.xpm 


      S ./pics/oeil13.xpm	     
	F  39   ,35,   36  

		R 300 300

	1111111111111111111111111111111111111111
	100002000000000010001002000000001111111111
	10000000020010002000100000000W1111111111	
	1000000000001001111110000000001111111111
	100002000120100100200000011111111111	
	100000001000100100000101111111111	
	100000000000100100000000000001111111111
	10002000000010000000000000001111111111
	100000002111111100000020000001111111111
	10000000000000111111111111111111111	
	11111111111111111111111111111111	

