R 1920 1080             
      NO    ./path_to_the_north_texture   
 SO ./path_to_the_south_texture
    WE ./path_to_the_west_texture
  EA ./path_to_the_east_texture


S ./path_to_the_sprite_texture
F220,100,10
C225,30,30

      11111111     1111111 11111111111
   11111111111111111 111111111111
        111011000111 110111111111         
        1000000000111000000000001          
        1011020000000000002000001          
        100100000W00000000000001
   1111111110110000111101000000011
   1000000000110001      001110111111111111
   1111111111111101      1100000010001   
         1111011111     1111011101111111111
         110000001101010111000000100001
   11111111110000000000000001111111111
   1000200000000001100000011111
   1000000000000000110101001
   1100000111010101111101111111
   111101110 1111101 11101101
   111111111111111111111111111
